
SO ./textures/colorstone.xpm
WE ./textures/eagle.xpm
EA ./textures/wall1.xpm
NO ./textures/wall3.xpm
F 0,100,0
C 123,30,250

11111111111
10000000001
10000000001
10000100001
10000000001
10000S00001
10000000001
11111111111
