
SO ./textures/colorstone.xpm
WE ./textures/eagle.xpm
EA ./textures/bluewall.xpm
NO ./textures/bloodwall.xpm
F 0,100,0
C 123,30,250

11111111111
10000000001
10000000001
10000000001
10000E00001
10000000001
10001110001
10001110001
11111111111
