

                                 SO ./textures/colorstone.xpm






                                                   WE ./textures/eagle.xpm
NO ./textures/bloodwall.xpm


  EA ./textures/bluewall.xpm





     F 0,100,0



C 123,30,250


111111     111111111
    1N1
1111111
