
WE ./textures/eagle.xpm
C 123,30,250
							SO ./textures/colorstone.xpm
EA ./textures/bluewall.xpm
NO ./textures/bloodwall.xpm
F 0,100,0


                   111111111
                   100000001
11111111111       10000000111111111111
10001100001        1000000011111111101
1000000000111111 111110000000000111111111
1111000E000000001 100000010000100111111111111
   1000000111111 11111110000000111111111111
11110000001           10000000111
10000000001           10000000101
10001110001           100000001111111111
11111111111           100000001
                      100011111
                      11111111111111111111
