
SO ./textures/colorstone.xpm
WE ./textures/eagle.xpm
EA ./textures/bluewall.xpm
NO ./textures/bloodwall.xpm
F 0,100,0
C 123,30,250


                   11111111
                   100000001
11111111111        100000001
10001100001        100000001111
1000000000111111111100000000001
1111000000000000000000100000001
   10S0000111111111111100000001
11110000001           100000001
10000000001           100000001
10001110001           100000001
11111111111           100000001
                      100011111
                      11111
