
WE ./textures/wall1.xpm
EA ./textures/wall2.xpm

NO ./textures/wall3.xpm
SO ./textures/wall4.xpm

F 220,100,0
C 253,30,0

11111111111
100000000S1
10000000001
10000000001
10000000001
10000000001
11111111111
