
SO ./textures/colorstone.xpm
WE ./textures/eagle.xpm
EA ./textures/bluewall.xpm
NO ./textures/bloodwall.xpm
F 0,100,0
C 123,30,250

11111111111
10001100001        111111111111
1000000000111111111100000000001
1000000000000000000000100000001
11000E0000111111111111100000001
10000000001           111111111
10000000001
10001110001
11111111111
